"a" = (/obj/machinery/computer/shuttle/mining{pixel_y = 32},/obj/effect/decal/wallpaper/blue{pixel_y = 32},/turf/open/floor/plating/vampplating/mono,/area/vtm/elysium/interior/elevator)
"b" = (/obj/machinery/light{dir = 4},/obj/effect/decal/wallpaper/blue{pixel_y = 32},/turf/open/floor/plating/vampplating/mono,/area/vtm/elysium/interior/elevator)
"c" = (/turf/open/floor/plating/vampplating/mono,/area/vtm/elysium/interior/elevator)
"d" = (/obj/docking_port/mobile{dir = 8; dwidth = 3; height = 5; id = "mining"; name = "elevator"; port_direction = 4; width = 7},/turf/open/floor/plating/vampplating/mono,/area/vtm/elysium/interior/elevator)

(1,1,1) = {"
ab
cd
"}
